Fish
12
000000000
001101000
001111100
000111100
001111100
000111000
000000000
000000000
000010000
000000000
001000000
000000000
000000000
000000000
