Star
7
00000000000000000
00000000100000000
00000001110000000
00000001110000000
00000011111000000
00000011111000000
00001111111110000
00111111111111100
01111111111111110
00111111111111100
00001111111110000
00000011111000000
00000011111000000
00000001110000000
00000001110000000
00000000100000000
00000000000000000
11111111111111111
10000001010000001
10000010001000001
10000010001000001
10000100000100001
10000100000100001
10010000000001001
11000000000000011
10000000000000001
11000000000000011
10010000000001001
10000100000100001
10000100000100001
10000010001000001
10000010001000001
10000001010000001
11111111111111111
