Ball
13
000000000
000111000
001111100
011111110
011111110
011111110
001111100
000111000
000000000
111111111
111000111
110000011
100000001
100000001
100000001
110000011
111000111
111111111
