Goblin
27
00000000000
00000100000
00001110000
00000100000
00001110000
00011111000
00111111100
00111111100
00111111100
00111111100
01111111110
00111111100
00001110000
00000100000
00000000000
11111111111
10001010001
10000000001
10001010001
10000000001
10100000101
10000000001
11000000011
11000000001
10000000011
10000000001
11000000001
10010001001
10001010001
11111111111
