Surprise
8
00000000
01100110
00000000
00011000
00111100
00011000
00000000
01100110
00000000
00000000
00000000
00000000
00000000
00000000
