Creeper
16
0000000000
0110000110
0111001110
0111001110
0011111100
0011111100
0001001000
0000000000
0000000000
1111111111
1000000001
1000000001
1000000001
1000000001
1000000001
1000110001
1000000001
1111111111
