Butterfly
13
000000000000000000000
000001110000000000000
000011110000000000000
000011111011000000000
000111111111100000000
001111111111100000000
001111111111100000000
001111111111100000000
001111111111011110000
011111111111111111000
011111111111111111000
011111111111111110000
000111110111111111000
000001101111111111110
000000011111111111110
000000011111111111110
000000001111111111100
000000001111111110000
000000000111111100000
000000000111000000000
000000000000000000000
111111111111111111111
100010001000000000001
100100001000010001001
100100000100100000001
101000000000010001001
110000000000010000001
110000000000010000001
110000000000010000001
110000000000100001001
100000000000000000101
100000000000000000101
100000000000000001001
101000001000000000101
100010010000000000001
100000100000000000001
100000000000000000001
100100010000000000011
100000000000000000001
100100001000000010001
100000001000100000101
111111111111111111111
